00100000000000000000
00101111111111110000
00101000000000010000
00111000000000010000
00000000000000010000
00011111111111110000
00010000000000000000
01110000000000000000
01000011111111111100
01000010000000000100
01111110000000011100
00000000001111110000
00111111111000000000
00200000000000000000
2
-1