00100000000000000000
00101111111111110000
00101000000000010000
00111000000000010000
00000000000000010000
00011111111111110000
00010000000000000000
01110000000000000000
01000011111111111100
01000010000000000100
01111110000000000100
00000000000001111100
00111111110001000000
00100000011111000000
00200000000000000000
2
3  (3 is for testing purposes, should be -1)