01001100011100001111
01001100011101001111
01001100011101101111
01001100011100001011
01001100011100001001
01000000011100001111
01001100011100001111
01001100011100001001
01001100011100001111
01001101011100001111
01001100011100001111
01001100011101001111
01001100011100011111
01001100011101001111
01001100011100101111